1111111111
1111111111
1111111111
11 1 11  1
11 1 11  1
 1 1 11  1
 1 1 1   1
 1   1   1
 1   1
     1


DESC=Level 0: ""